NO assets/wall_no.xpm
EA assets/wall_ea.xpm
SO assets/wall_so.xpm
WE assets/wall_we.xpm
F 184,113,  70
C 51,   0,   155
11111
 1N001111111
10000000001
11111111111