NO ./assets/alice_tx.xpm
EA ./assets/alice_tx.xpm
SO ./assets/alice_tx.xpm
WE ./assets/komi_tx.xpm

F 50, 50, 50

11111111
10100001
10100001
10100001
100N0001
10000101
10000001
11111111